90
0
13
5
3
1
0
+P+C+P+P+
BPPBCBPBC
+P+P+C+P+
CBPBPBPBP
+P+P+C+P+
