0
90
13
5
3
1
0
+P+P+B+P+
PBPBVBBBP
+P+B+P+P+
BBPBPBPBP
+P+B+V+P+
